##########
#.....S..#
#.###.####
#...#.####
###.#.####
#####.#.##
#...#.##.#
#........#
#....E...#
##########
